"","Date_received","Coupon_sent","Coupon_used","ratio","Coupon_no"
"1",2016-01-01,554,74,0.133574007220217,480
"2",2016-01-02,542,67,0.123616236162362,475
"3",2016-01-03,536,74,0.138059701492537,462
"4",2016-01-04,577,98,0.169844020797227,479
"5",2016-01-05,691,107,0.154848046309696,584
"6",2016-01-06,808,148,0.183168316831683,660
"7",2016-01-07,746,120,0.160857908847185,626
"8",2016-01-08,970,139,0.143298969072165,831
"9",2016-01-09,1003,124,0.123629112662014,879
"10",2016-01-10,869,109,0.125431530494822,760
"11",2016-01-11,712,108,0.151685393258427,604
"12",2016-01-12,773,104,0.134540750323415,669
"13",2016-01-13,1459,204,0.139821795750514,1255
"14",2016-01-14,1520,211,0.138815789473684,1309
"15",2016-01-15,1665,234,0.140540540540541,1431
"16",2016-01-16,1517,151,0.0995385629531971,1366
"17",2016-01-17,1546,172,0.111254851228978,1374
"18",2016-01-18,1177,115,0.0977060322854715,1062
"19",2016-01-19,1283,140,0.109119251753702,1143
"20",2016-01-20,1166,156,0.133790737564322,1010
"21",2016-01-21,1194,143,0.119765494137353,1051
"22",2016-01-22,1236,139,0.112459546925566,1097
"23",2016-01-23,24045,791,0.0328966521106259,23254
"24",2016-01-24,39481,935,0.0236822775512272,38546
"25",2016-01-25,65904,1007,0.015279800922554,64897
"26",2016-01-26,26027,739,0.0283935912706036,25288
"27",2016-01-27,18893,758,0.0401206796167893,18135
"28",2016-01-28,34334,1050,0.0305819304479525,33284
"29",2016-01-29,71658,2341,0.0326690669569343,69317
"30",2016-01-30,33226,1205,0.0362667790284717,32021
"31",2016-01-31,35427,1298,0.036638721878793,34129
"32",2016-02-01,16371,706,0.0431250381772647,15665
"33",2016-02-02,11253,436,0.0387452234959566,10817
"34",2016-02-03,17494,609,0.03481193552075,16885
"35",2016-02-04,14450,602,0.0416608996539792,13848
"36",2016-02-05,4659,521,0.1118265722258,4138
"37",2016-02-06,3115,419,0.134510433386838,2696
"38",2016-02-07,33319,1375,0.0412677451304061,31944
"39",2016-02-08,1967,76,0.0386375190645653,1891
"40",2016-02-09,1173,84,0.0716112531969309,1089
"41",2016-02-10,3365,82,0.0243684992570579,3283
"42",2016-02-11,3093,105,0.0339476236663434,2988
"43",2016-02-12,3730,112,0.0300268096514745,3618
"44",2016-02-13,4007,111,0.0277015223359122,3896
"45",2016-02-14,4013,149,0.0371293296785447,3864
"46",2016-02-15,701,80,0.114122681883024,621
"47",2016-02-16,685,74,0.108029197080292,611
"48",2016-02-17,618,84,0.135922330097087,534
"49",2016-02-18,543,69,0.12707182320442,474
"50",2016-02-19,669,89,0.133034379671151,580
"51",2016-02-20,848,86,0.101415094339623,762
"52",2016-02-21,670,76,0.113432835820896,594
"53",2016-02-22,667,87,0.130434782608696,580
"54",2016-02-23,554,60,0.108303249097473,494
"55",2016-02-24,633,70,0.110584518167457,563
"56",2016-02-25,780,100,0.128205128205128,680
"57",2016-02-26,902,98,0.108647450110865,804
"58",2016-02-27,1073,101,0.0941286113699907,972
"59",2016-02-28,1216,105,0.0863486842105263,1111
"60",2016-02-29,865,101,0.116763005780347,764
"61",2016-03-01,902,70,0.0776053215077605,832
"62",2016-03-02,578,55,0.0951557093425606,523
"63",2016-03-03,566,71,0.125441696113074,495
"64",2016-03-04,768,110,0.143229166666667,658
"65",2016-03-05,933,118,0.126473740621651,815
"66",2016-03-06,1000,106,0.106,894
"67",2016-03-07,609,77,0.126436781609195,532
"68",2016-03-08,786,104,0.132315521628499,682
"69",2016-03-09,694,88,0.126801152737752,606
"70",2016-03-10,956,89,0.0930962343096234,867
"71",2016-03-11,786,116,0.147582697201018,670
"72",2016-03-12,1006,108,0.107355864811133,898
"73",2016-03-13,935,94,0.100534759358289,841
"74",2016-03-14,619,72,0.116316639741519,547
"75",2016-03-15,788,71,0.0901015228426396,717
"76",2016-03-16,715,86,0.12027972027972,629
"77",2016-03-17,700,78,0.111428571428571,622
"78",2016-03-18,840,91,0.108333333333333,749
"79",2016-03-19,1026,122,0.118908382066277,904
"80",2016-03-20,977,105,0.107471852610031,872
"81",2016-03-21,9923,2325,0.234304141892573,7598
"82",2016-03-22,9826,2250,0.228984327294932,7576
"83",2016-03-23,9754,2079,0.21314332581505,7675
"84",2016-03-24,9283,1759,0.18948615749219,7524
"85",2016-03-25,11265,1764,0.15659121171771,9501
"86",2016-03-26,13719,1811,0.132006706028136,11908
"87",2016-03-27,13341,1692,0.126827074432201,11649
"88",2016-03-28,2289,159,0.0694626474442988,2130
"89",2016-03-29,2754,190,0.0689905591866376,2564
"90",2016-03-30,2715,172,0.0633517495395948,2543
"91",2016-03-31,2850,180,0.0631578947368421,2670
"92",2016-04-01,3883,179,0.0460983775431367,3704
"93",2016-04-02,3380,136,0.0402366863905325,3244
"94",2016-04-03,3210,115,0.0358255451713396,3095
"95",2016-04-04,3450,116,0.0336231884057971,3334
"96",2016-04-05,3656,119,0.0325492341356674,3537
"97",2016-04-06,3245,105,0.0323574730354391,3140
"98",2016-04-07,4848,161,0.0332095709570957,4687
"99",2016-04-08,3766,173,0.0459373340414233,3593
"100",2016-04-09,3557,155,0.0435760472308125,3402
"101",2016-04-10,3861,147,0.0380730380730381,3714
"102",2016-04-11,3620,133,0.0367403314917127,3487
"103",2016-04-12,4366,167,0.038250114521301,4199
"104",2016-04-13,3952,167,0.0422570850202429,3785
"105",2016-04-14,4724,292,0.0618120237087214,4432
"106",2016-04-15,5360,232,0.0432835820895522,5128
"107",2016-04-16,5400,218,0.0403703703703704,5182
"108",2016-04-17,4348,170,0.0390984360625575,4178
"109",2016-04-18,4902,260,0.0530395756833945,4642
"110",2016-04-19,4424,195,0.0440777576853526,4229
"111",2016-04-20,4651,214,0.0460116104063642,4437
"112",2016-04-21,5035,412,0.0818272095332671,4623
"113",2016-04-22,7381,361,0.0489093618750847,7020
"114",2016-04-23,4730,306,0.0646934460887949,4424
"115",2016-04-24,6490,336,0.0517719568567026,6154
"116",2016-04-25,4965,313,0.0630412890231621,4652
"117",2016-04-26,4579,301,0.0657348766106137,4278
"118",2016-04-27,5565,318,0.0571428571428571,5247
"119",2016-04-28,6104,464,0.0760157273918742,5640
"120",2016-04-29,5634,395,0.0701100461483848,5239
"121",2016-04-30,5008,336,0.0670926517571885,4672
"122",2016-05-01,3121,258,0.0826658122396668,2863
"123",2016-05-02,3276,268,0.0818070818070818,3008
"124",2016-05-03,1885,312,0.16551724137931,1573
"125",2016-05-04,2154,322,0.149489322191272,1832
"126",2016-05-05,3371,462,0.137051320083061,2909
"127",2016-05-06,2667,380,0.142482189726284,2287
"128",2016-05-07,2731,333,0.121933357744416,2398
"129",2016-05-08,3746,357,0.095301655098772,3389
"130",2016-05-09,3919,379,0.0967083439652973,3540
"131",2016-05-10,2887,417,0.14444059577416,2470
"132",2016-05-11,4215,482,0.11435349940688,3733
"133",2016-05-12,3710,665,0.179245283018868,3045
"134",2016-05-13,4788,677,0.141395154553049,4111
"135",2016-05-14,5397,623,0.115434500648508,4774
"136",2016-05-15,5860,505,0.0861774744027304,5355
"137",2016-05-16,5092,664,0.130400628436764,4428
"138",2016-05-17,7797,713,0.0914454277286136,7084
"139",2016-05-18,9440,759,0.0804025423728814,8681
"140",2016-05-19,10215,845,0.0827214880078316,9370
"141",2016-05-20,14796,2353,0.159029467423628,12443
"142",2016-05-21,19859,2239,0.112744851200967,17620
"143",2016-05-22,13299,2048,0.153996541093315,11251
"144",2016-05-23,11008,1884,0.171148255813953,9124
"145",2016-05-24,10998,1876,0.170576468448809,9122
"146",2016-05-25,13576,1871,0.137816735415439,11705
"147",2016-05-26,8285,664,0.08014484007242,7621
"148",2016-05-27,6721,537,0.0798988245796756,6184
"149",2016-05-28,13276,524,0.039469719795119,12752
"150",2016-05-29,5720,538,0.0940559440559441,5182
"151",2016-05-30,5076,483,0.0951536643026005,4593
"152",2016-05-31,6463,478,0.0739594615503636,5985
"153",2016-06-01,7443,706,0.0948542254467285,6737
"154",2016-06-02,9149,802,0.0876598535359056,8347
"155",2016-06-03,7664,660,0.0861169102296451,7004
"156",2016-06-04,5602,529,0.0944305605141021,5073
"157",2016-06-05,5624,458,0.0814366998577525,5166
"158",2016-06-06,6519,586,0.0898910875901212,5933
"159",2016-06-07,5487,500,0.0911244760342628,4987
"160",2016-06-08,6146,559,0.0909534656687276,5587
"161",2016-06-09,6315,468,0.0741092636579572,5847
"162",2016-06-10,5709,393,0.068838675775092,5316
"163",2016-06-11,5211,351,0.0673575129533679,4860
"164",2016-06-12,4005,330,0.0823970037453183,3675
"165",2016-06-13,7861,439,0.0558453123012339,7422
"166",2016-06-14,4755,394,0.0828601472134595,4361
"167",2016-06-15,3475,355,0.102158273381295,3120
