"","Date","Coupon_used","Coupon_no","ratio","total"
"1",2016-01-01,36,2552,0.0139103554868624,2588
"2",2016-01-02,36,2385,0.0148698884758364,2421
"3",2016-01-03,57,2554,0.0218307162006894,2611
"4",2016-01-04,47,2448,0.0188376753507014,2495
"5",2016-01-05,54,2473,0.0213692125049466,2527
"6",2016-01-06,77,2636,0.0283818650939919,2713
"7",2016-01-07,72,2658,0.0263736263736264,2730
"8",2016-01-08,93,3216,0.028105167724388,3309
"9",2016-01-09,84,3027,0.0270009643201543,3111
"10",2016-01-10,75,2934,0.0249252243270189,3009
"11",2016-01-11,87,2493,0.0337209302325581,2580
"12",2016-01-12,79,2717,0.0282546494992847,2796
"13",2016-01-13,88,2824,0.0302197802197802,2912
"14",2016-01-14,90,2886,0.030241935483871,2976
"15",2016-01-15,137,3131,0.041921664626683,3268
"16",2016-01-16,116,3135,0.035681328821901,3251
"17",2016-01-17,127,3022,0.0403302635757383,3149
"18",2016-01-18,135,2667,0.0481798715203426,2802
"19",2016-01-19,124,2797,0.0424512153372133,2921
"20",2016-01-20,140,2745,0.048526863084922,2885
"21",2016-01-21,152,2638,0.0544802867383513,2790
"22",2016-01-22,164,2675,0.0577668193025713,2839
"23",2016-01-23,181,3846,0.0449466103799354,4027
"24",2016-01-24,293,3722,0.0729763387297634,4015
"25",2016-01-25,330,3566,0.0847022587268994,3896
"26",2016-01-26,284,3360,0.0779363336992316,3644
"27",2016-01-27,304,3360,0.0829694323144105,3664
"28",2016-01-28,348,3409,0.0926270960873037,3757
"29",2016-01-29,595,3300,0.152759948652118,3895
"30",2016-01-30,754,3542,0.175512104283054,4296
"31",2016-01-31,881,3079,0.222474747474747,3960
"32",2016-02-01,592,2598,0.185579937304075,3190
"33",2016-02-02,635,2756,0.187260395163669,3391
"34",2016-02-03,625,2670,0.189681335356601,3295
"35",2016-02-04,652,2706,0.194163192376415,3358
"36",2016-02-05,775,2762,0.219112242013005,3537
"37",2016-02-06,694,2305,0.231410470156719,2999
"38",2016-02-07,552,1180,0.318706697459584,1732
"39",2016-02-08,530,921,0.36526533425224,1451
"40",2016-02-09,527,1023,0.34,1550
"41",2016-02-10,441,1128,0.281070745697897,1569
"42",2016-02-11,387,1211,0.242177722152691,1598
"43",2016-02-12,338,1304,0.20584652862363,1642
"44",2016-02-13,376,1502,0.200212992545261,1878
"45",2016-02-14,476,2199,0.177943925233645,2675
"46",2016-02-15,422,2158,0.163565891472868,2580
"47",2016-02-16,368,2262,0.139923954372624,2630
"48",2016-02-17,333,2371,0.123150887573965,2704
"49",2016-02-18,347,2420,0.125406577520781,2767
"50",2016-02-19,348,2434,0.12508986340762,2782
"51",2016-02-20,447,2457,0.153925619834711,2904
"52",2016-02-21,441,2453,0.152384243261921,2894
"53",2016-02-22,359,2467,0.127034677990092,2826
"54",2016-02-23,225,2559,0.0808189655172414,2784
"55",2016-02-24,277,2721,0.0923949299533022,2998
"56",2016-02-25,257,2786,0.0844561288202432,3043
"57",2016-02-26,308,2957,0.094333843797856,3265
"58",2016-02-27,410,3118,0.116213151927438,3528
"59",2016-02-28,533,3439,0.134189325276939,3972
"60",2016-02-29,485,2893,0.143576080521018,3378
"61",2016-03-01,70,2955,0.0231404958677686,3025
"62",2016-03-02,61,2903,0.0205802968960864,2964
"63",2016-03-03,61,2835,0.0210635359116022,2896
"64",2016-03-04,85,3356,0.024702121476315,3441
"65",2016-03-05,79,3522,0.0219383504582061,3601
"66",2016-03-06,92,3346,0.0267597440372309,3438
"67",2016-03-07,74,3055,0.0236497283477149,3129
"68",2016-03-08,69,3063,0.0220306513409962,3132
"69",2016-03-09,62,3075,0.019764105833599,3137
"70",2016-03-10,70,3061,0.0223570744171191,3131
"71",2016-03-11,75,3614,0.0203307129303334,3689
"72",2016-03-12,81,3637,0.021785906401291,3718
"73",2016-03-13,76,3339,0.0222547584187409,3415
"74",2016-03-14,69,3263,0.0207082833133253,3332
"75",2016-03-15,69,3286,0.0205663189269747,3355
"76",2016-03-16,72,3378,0.0208695652173913,3450
"77",2016-03-17,58,3305,0.0172465060957478,3363
"78",2016-03-18,73,3651,0.0196025778732546,3724
"79",2016-03-19,81,3667,0.0216115261472785,3748
"80",2016-03-20,86,3628,0.0231556273559505,3714
"81",2016-03-21,57,6980,0.00810004263180332,7037
"82",2016-03-22,359,7120,0.0480010696617195,7479
"83",2016-03-23,665,7172,0.0848538981753222,7837
"84",2016-03-24,874,6951,0.111693290734824,7825
"85",2016-03-25,1164,8441,0.121186881832379,9605
"86",2016-03-26,1076,9167,0.105047349409353,10243
"87",2016-03-27,1318,8907,0.128899755501222,10225
"88",2016-03-28,1387,3983,0.25828677839851,5370
"89",2016-03-29,1362,3466,0.282104391052196,4828
"90",2016-03-30,1421,3307,0.300549915397631,4728
"91",2016-03-31,1291,3612,0.263308178666123,4903
"92",2016-04-01,1127,3860,0.225987567675957,4987
"93",2016-04-02,825,3183,0.205838323353293,4008
"94",2016-04-03,690,2821,0.196525206493876,3511
"95",2016-04-04,599,3122,0.160978231658156,3721
"96",2016-04-05,300,3599,0.0769428058476532,3899
"97",2016-04-06,123,3360,0.0353143841515935,3483
"98",2016-04-07,143,3613,0.0380724174653887,3756
"99",2016-04-08,166,4067,0.0392156862745098,4233
"100",2016-04-09,163,3782,0.041318124207858,3945
"101",2016-04-10,163,3800,0.0411304567247035,3963
"102",2016-04-11,133,3655,0.0351108764519535,3788
"103",2016-04-12,153,3706,0.039647577092511,3859
"104",2016-04-13,149,3843,0.0373246492985972,3992
"105",2016-04-14,139,4346,0.0309921962095875,4485
"106",2016-04-15,176,4332,0.0390417036379769,4508
"107",2016-04-16,201,4108,0.0466465537247621,4309
"108",2016-04-17,196,4250,0.0440845704003599,4446
"109",2016-04-18,171,4117,0.0398787313432836,4288
"110",2016-04-19,181,3909,0.0442542787286064,4090
"111",2016-04-20,173,3688,0.0448070448070448,3861
"112",2016-04-21,199,4688,0.0407202782893391,4887
"113",2016-04-22,262,4646,0.0533822330888346,4908
"114",2016-04-23,259,4511,0.0542976939203354,4770
"115",2016-04-24,275,4480,0.0578338590956887,4755
"116",2016-04-25,242,4228,0.0541387024608501,4470
"117",2016-04-26,260,4011,0.0608756731444627,4271
"118",2016-04-27,286,4388,0.0611895592640137,4674
"119",2016-04-28,319,5403,0.0557497378538972,5722
"120",2016-04-29,361,5059,0.0666051660516605,5420
"121",2016-04-30,327,4596,0.0664229128580134,4923
"122",2016-05-01,283,4060,0.065162330186507,4343
"123",2016-05-02,251,3658,0.0642107955998977,3909
"124",2016-05-03,265,4163,0.0598464317976513,4428
"125",2016-05-04,323,4065,0.0736098450319052,4388
"126",2016-05-05,310,4694,0.0619504396482814,5004
"127",2016-05-06,341,4751,0.066967792615868,5092
"128",2016-05-07,328,4616,0.0663430420711974,4944
"129",2016-05-08,348,4600,0.0703314470493129,4948
"130",2016-05-09,306,3927,0.072289156626506,4233
"131",2016-05-10,339,4389,0.0717005076142132,4728
"132",2016-05-11,331,4598,0.0671535808480422,4929
"133",2016-05-12,362,5105,0.0662154746661789,5467
"134",2016-05-13,383,5684,0.0631283995384869,6067
"135",2016-05-14,385,6093,0.0594319234331584,6478
"136",2016-05-15,378,5262,0.0670212765957447,5640
"137",2016-05-16,437,5264,0.0766532187335555,5701
"138",2016-05-17,466,5049,0.0844968268359021,5515
"139",2016-05-18,510,5222,0.0889741800418702,5732
"140",2016-05-19,577,5407,0.0964237967914438,5984
"141",2016-05-20,709,8763,0.0748521959459459,9472
"142",2016-05-21,864,9019,0.0874228473135688,9883
"143",2016-05-22,1068,8645,0.109955729434778,9713
"144",2016-05-23,1060,6571,0.138907089503342,7631
"145",2016-05-24,1206,6614,0.154219948849105,7820
"146",2016-05-25,1349,6482,0.172264078661729,7831
"147",2016-05-26,1323,4626,0.222390317700454,5949
"148",2016-05-27,1401,4859,0.223801916932907,6260
"149",2016-05-28,1253,4950,0.2019990327261,6203
"150",2016-05-29,1285,4919,0.20712443584784,6204
"151",2016-05-30,1169,4388,0.210365305020695,5557
"152",2016-05-31,1028,4353,0.191042557145512,5381
"153",2016-06-01,1046,4821,0.17828532469746,5867
"154",2016-06-02,963,4711,0.169721536834685,5674
"155",2016-06-03,796,4685,0.14522897281518,5481
"156",2016-06-04,826,4941,0.143228715103173,5767
"157",2016-06-05,632,4963,0.11295799821269,5595
"158",2016-06-06,657,4474,0.12804521535763,5131
"159",2016-06-07,610,4445,0.120672601384768,5055
"160",2016-06-08,727,4756,0.132591646908627,5483
"161",2016-06-09,642,4917,0.11548839719374,5559
"162",2016-06-10,548,4109,0.117672321236848,4657
"163",2016-06-11,507,4003,0.112416851441242,4510
"164",2016-06-12,523,4000,0.115631218217997,4523
"165",2016-06-13,596,4301,0.121707167653666,4897
"166",2016-06-14,554,4252,0.115272575946733,4806
"167",2016-06-15,620,4331,0.125227226822864,4951
"168",2016-06-16,537,3571,0.130720545277507,4108
"169",2016-06-17,473,3707,0.113157894736842,4180
"170",2016-06-18,440,3505,0.111533586818758,3945
"171",2016-06-19,348,3349,0.0941303759805247,3697
"172",2016-06-20,310,3677,0.0777526962628543,3987
"173",2016-06-21,242,3671,0.0618451316125735,3913
"174",2016-06-22,247,3686,0.0628019323671498,3933
"175",2016-06-23,243,3889,0.0588092933204259,4132
"176",2016-06-24,267,4116,0.0609171800136893,4383
"177",2016-06-25,235,4183,0.0531914893617021,4418
"178",2016-06-26,199,3637,0.0518769551616267,3836
"179",2016-06-27,142,3640,0.0375462718138551,3782
"180",2016-06-28,160,3485,0.0438957475994513,3645
"181",2016-06-29,127,3605,0.0340300107181136,3732
"182",2016-06-30,129,3603,0.0345659163987138,3732
